NO textures/simonkraft/respawn_anchor_side0.xpm
EA textures/simonkraft/respawn_anchor_side2.xpm
SO textures/simonkraft/respawn_anchor_side4.xpm
WE textures/simonkraft/respawn_anchor_side3.xpm

C 35,19,73
F 15,6,40

         111111
        10000001
       1000000001
      100000000001
     10000000000001
    1000000000000001
   100000000000000001
  10000000000000000001
 1000000000000000000001
100000000000000000000001
 1000000000000000000001
  10000000000000000001
   100000000000000001
    1000000000000001
     10000000000001
      100000000001
       1000000001
        10000001
         100001
         111111